11111111
10000001
11000001
11011001
11111111