NO ./texture/text.xpm
SO ./texture/texst.xpm
WE ./texture/rrr.xpm
EA ./texture/rrr.xpm







F 220,100,0
C 225,30,0




11111111111111
10000000000001
11001110000001
11000W10011111
11101111100001
10010000000001
11111111111111