                NO ./assets/lala
        	SO ./assets/a
WE ./assets/a
EA ./assets/a







F 220,100,0
C 225,30,0




1111111
1000N01
1100001
1111111

