NO ./assets/lala
SO ./assets/a
WE ./assets/a
EA ./assets/a







F 220,100,0
C 225,30,0




11111111111111
10000000000001
11000000000001
11000S00011111
11100001100001
1  10000000001
11111111111111
