NO ./texture/rrr.xpm
SO ./texture/rrr.xpm
WE ./texture/rrr.xpm
EA ./texture/rrr.xpm







F 220,100,0
C 225,30,0




11111111111111
10000000000001
11001110000001
11000S10011111
11101111100001
1  10000000001
11111111111111
